border_size=1
usage=map

Xu          , Xu          , Xu          , Xu          , Xu          , Xu          , Xu          , Xu          , Xu          , Gs          , Xu          , Xu          , Xu          , Xu          
Xu          , Xuce        , Xuce        , Xuce        , Xuce        , Xuce        , Xuce        , Xuce        , Xuce        , Rb^Srj      , Xuce        , Xuce        , Xu          , Xu          
Xu          , Xuce        , Xuce        , Rb^Mtr      , Rb^Mtr      , Rb^Bz       , Xuce        , Xuce        , Xuce        , Rb          , Xuce        , Xuce        , Xu          , Xu          
Xu          , Xu          , Xuce        , Xuce        , Rb          , Rb          , Rb          , Rb          , Rb          , Rb^Zdwo     , Xuce        , Xuce        , Xuce        , Xu          
Xu          , Xuce        , Xuce        , Xuce        , Rb          , Rb          , Rb          , Rb          , Rb          , Rb^Bz       , Xuce        , Xuce        , Xu          , Xu          
Xu          , Xuce        , Xuce        , Rb^Che      , Rb          , Rb          , Rb^Tab      , Rb          , Rb          , Rb          , Xuce        , Xuce        , Xu          , Xu          
Xu          , Xu          , Xuce        , Rb          , Rb^Str      , Rb          , Rb          , Rb          , Rb          , Rb^Coa      , Xuce        , Xuce        , Xuce        , Xu          
Xu          , Xu          , Xuc         , Xuc         , Xuc         , Xuc         , Xuc         , Xuc         , Xuc         , Xuc         , Xuc         , Xuc         , Xuc         , Xu          
Xu          , Xu          , Xu          , Xu          , Xu          , Xu          , Xu          , Xu          , Xu          , Xu          , Xu          , Xu          , Xu          , Xu          
